{
	"level":[
		{
			"tileX":12,
			"tileY":12,
			"map":[ 0,0,0,0,0,0,0,0,0,0,0,0,
					0,0,0,0,0,0,0,0,0,1,1,1,
					0,0,0,0,0,0,0,0,0,1,0,0,
					0,0,0,0,0,0,0,0,0,1,0,0,
					0,0,0,0,0,0,0,0,0,1,0,0,
					0,0,0,0,0,0,0,0,0,1,0,0,
					0,0,1,1,1,1,1,1,1,1,0,0,
					0,0,1,0,0,0,0,0,0,0,0,0,
					0,0,1,1,1,1,0,0,0,0,0,0,
					0,0,0,0,0,1,0,0,0,0,0,0,
					0,1,1,1,1,1,0,0,0,0,0,0,
					0,1,0,0,0,0,0,0,0,0,0,0 ],
			"placeable":
				  [ 0,0,0,0,0,0,0,0,1,1,1,1,
					0,0,0,0,0,0,0,0,1,0,0,0,
					0,0,0,0,0,0,0,0,1,0,1,1,
					0,0,0,0,0,0,0,0,1,0,1,0,
					0,0,0,0,0,0,0,0,1,0,1,0,
					0,1,1,1,1,1,1,1,1,0,1,0,
					0,1,0,0,0,0,0,0,0,0,1,0,
					0,1,0,1,1,1,1,1,1,1,1,0,
					0,1,0,0,0,0,1,0,0,0,0,0,
					1,1,1,1,1,0,1,0,0,0,0,0,
					1,0,0,0,0,0,1,0,0,0,0,0,
					1,0,1,1,1,1,1,0,0,0,0,0 ],
			"path":[
					[1, 11],
					[1, 10],
					[5, 10],
					[5, 8],
					[2, 8],
					[2, 6],
					[9, 6],
					[9, 1],
					[11, 1]
			]
		},
		{
			"tileX":12,
			"tileY":12,
			"map":[ 0,0,0,0,0,0,0,0,0,1,0,0,
					0,0,0,0,0,0,0,0,0,1,0,0,
					0,0,0,0,0,0,0,0,0,1,0,0,
					0,0,1,1,1,1,1,1,1,1,0,0,
					0,0,1,0,0,0,0,0,0,0,0,0,
					0,0,1,0,0,0,0,0,0,0,0,0,
					0,0,1,1,1,1,1,1,1,1,1,0,
					0,0,0,0,0,0,0,0,0,0,1,0,
					0,1,1,1,1,1,1,1,1,1,1,0,
					0,1,0,0,0,0,0,0,0,0,0,0,
					0,1,0,0,0,0,0,0,0,0,0,0,
					0,1,0,0,0,0,0,0,0,0,0,0 ],
			"placeable":
				  [ 0,0,0,0,0,0,0,0,1,0,1,0,
					0,0,0,0,0,0,0,0,1,0,1,0,
					0,1,1,1,1,1,1,1,1,0,1,0,
					0,1,0,0,0,0,0,0,0,0,1,0,
					0,1,0,1,1,1,1,1,1,1,1,0,
					0,1,0,1,1,1,1,1,1,1,1,1,
					0,1,0,0,0,0,0,0,0,0,0,1,
					1,1,1,1,1,1,1,1,1,1,0,1,
					1,0,0,0,0,0,0,0,0,0,0,1,
					1,0,1,1,1,1,1,1,1,1,1,1,
					1,0,1,0,0,0,0,0,0,0,0,0,
					1,0,1,0,0,0,0,0,0,0,0,0 ],
			"path":[
					[1, 11],
					[1, 8],
					[10, 8],
					[10, 6],
					[2, 6],
					[2, 3],
					[9, 3],
					[9, 0]
			]
		}
	]
}