{
	"level":[
		{
			"tileX":20,
			"tileY":20,
			"map":[ 0,0,0,0,0,0,0,0,0,0,0,0,0,0,0,1,1,1,0,0,
					0,0,0,0,0,0,0,0,0,0,0,0,0,0,0,1,1,1,0,0,
					0,0,0,1,1,1,1,0,0,0,0,0,0,0,0,1,1,1,0,0,
					0,0,0,1,1,1,1,0,0,0,0,0,0,0,0,0,0,0,0,0,
					0,0,0,1,1,1,1,0,0,0,0,0,0,0,0,0,0,0,0,0,
					0,0,0,1,1,1,1,0,0,0,0,2,2,2,2,2,2,2,2,2,
					0,0,0,0,0,0,0,0,0,0,0,0,0,0,0,0,0,0,0,0,
					0,0,0,0,0,0,0,0,0,0,0,0,0,0,0,0,0,0,0,0,
					0,0,0,0,0,0,0,0,0,0,0,0,0,0,0,0,0,0,0,0,
					0,0,0,0,0,0,0,0,0,0,0,0,0,0,0,0,0,0,0,0,
					0,0,0,0,0,0,0,0,0,0,0,0,0,0,0,0,0,0,0,0,
					0,0,0,0,0,0,0,0,0,0,0,0,0,0,0,0,0,0,0,0,
					0,0,0,0,0,0,0,0,0,0,0,0,0,0,1,1,1,1,0,0,
					0,0,0,2,2,2,2,2,2,2,2,0,0,0,1,1,1,1,0,0,
					0,0,0,0,0,0,0,0,2,2,2,0,0,0,1,1,1,1,0,0,
					0,0,0,0,0,0,0,0,0,2,2,0,0,0,1,1,1,1,0,0,
					0,0,0,0,0,0,0,0,0,0,2,0,0,0,0,0,0,0,0,0,
					0,0,1,1,1,0,0,0,0,0,0,0,0,0,0,0,0,0,0,0,
					0,0,1,1,1,0,0,0,0,0,0,0,0,0,0,0,0,0,0,0,
					0,0,1,1,1,0,0,0,0,0,0,0,0,0,0,0,0,0,0,0 ],
			"placeable":
				  [ 1,1,1,1,1,1,1,1,1,1,1,1,1,1,1,1,1,1,1,1,
					1,1,1,1,1,1,1,1,1,1,1,1,1,1,1,1,1,1,1,1,
					1,1,1,1,1,1,1,1,1,1,1,1,1,1,1,1,1,1,1,1,
					1,1,1,1,1,1,1,1,1,1,1,1,1,1,1,1,1,1,1,1,
					1,1,1,1,1,1,1,1,1,1,1,1,1,1,1,1,1,1,1,1,
					1,1,1,1,1,1,1,1,1,1,1,0,0,0,0,0,0,0,0,0,
					1,1,1,1,1,1,1,1,1,1,1,1,1,1,1,1,1,1,1,1,
					1,1,1,1,1,1,1,1,1,1,1,1,1,1,1,1,1,1,1,1,
					1,1,1,1,1,1,1,1,1,1,1,1,1,1,1,1,1,1,1,1,
					1,1,1,1,1,1,1,1,1,1,1,1,1,1,1,1,1,1,1,1,
					1,1,1,1,1,1,1,1,1,1,1,1,1,1,1,1,1,1,1,1,
					1,1,1,1,1,1,1,1,1,1,1,1,1,1,1,1,1,1,1,1,
					1,1,1,1,1,1,1,1,1,1,1,1,1,1,1,1,1,1,1,1,
					1,1,1,0,0,0,0,0,0,0,0,1,1,1,1,1,1,1,1,1,
					1,1,1,1,1,1,1,1,0,0,0,1,1,1,1,1,1,1,1,1,
					1,1,1,1,1,1,1,1,1,0,0,1,1,1,1,1,1,1,1,1,
					1,1,1,1,1,1,1,1,1,1,0,1,1,1,1,1,1,1,1,1,
					1,1,1,1,1,1,1,1,1,1,1,1,1,1,1,1,1,1,1,1,
					1,1,1,1,1,1,1,1,1,1,1,1,1,1,1,1,1,1,1,1,
					1,1,1,1,1,1,1,1,1,1,1,1,1,1,1,1,1,1,1,1 ],
			"walkable":
				  [ 1,1,1,1,1,1,1,1,1,1,1,1,1,1,1,1,1,1,1,1,
					1,1,1,1,1,1,1,1,1,1,1,1,1,1,1,1,1,1,1,1,
					1,1,1,1,1,1,1,1,1,1,1,1,1,1,1,1,1,1,1,1,
					1,1,1,1,1,1,1,1,1,1,1,1,1,1,1,1,1,1,1,1,
					1,1,1,1,1,1,1,1,1,1,1,1,1,1,1,1,1,1,1,1,
					1,1,1,1,1,1,1,1,1,1,1,0,0,0,0,0,0,0,0,0,
					1,1,1,1,1,1,1,1,1,1,1,1,1,1,1,1,1,1,1,1,
					1,1,1,1,1,1,1,1,1,1,1,1,1,1,1,1,1,1,1,1,
					1,1,1,1,1,1,1,1,1,1,1,1,1,1,1,1,1,1,1,1,
					1,1,1,1,1,1,1,1,1,1,1,1,1,1,1,1,1,1,1,1,
					1,1,1,1,1,1,1,1,1,1,1,1,1,1,1,1,1,1,1,1,
					1,1,1,1,1,1,1,1,1,1,1,1,1,1,1,1,1,1,1,1,
					1,1,1,1,1,1,1,1,1,1,1,1,1,1,1,1,1,1,1,1,
					1,1,1,0,0,0,0,0,0,0,0,1,1,1,1,1,1,1,1,1,
					1,1,1,1,1,1,1,1,0,0,0,1,1,1,1,1,1,1,1,1,
					1,1,1,1,1,1,1,1,1,0,0,1,1,1,1,1,1,1,1,1,
					1,1,1,1,1,1,1,1,1,1,0,1,1,1,1,1,1,1,1,1,
					1,1,1,1,1,1,1,1,1,1,1,1,1,1,1,1,1,1,1,1,
					1,1,1,1,1,1,1,1,1,1,1,1,1,1,1,1,1,1,1,1,
					1,1,1,1,1,1,1,1,1,1,1,1,1,1,1,1,1,1,1,1 ],
			"path":[
					[3, 19],
					[16, 14],
					[3, 3],
					[16, 0]
			]
		}
	]
}